1111111111111
10010000000C1
10E0011111001
10P01100C0001
1111111111111